<code>
#Opciones de shopt de Bash
autocd         	off
assoc_expand_once	off
cdable_vars    	off
cdspell        	off
checkhash      	off
checkjobs      	off
checkwinsize   	on
cmdhist        	on
compat31       	off
compat32       	off
compat40       	off
compat41       	off
compat42       	off
compat43       	off
compat44       	off
complete_fullquote	on
direxpand      	off
dirspell       	off
dotglob        	off
execfail       	off
expand_aliases 	on
extdebug       	off
extglob        	on
extquote       	on
failglob       	off
force_fignore  	on
globasciiranges	on
globstar       	off
gnu_errfmt     	off
histappend     	on
histreedit     	off
histverify     	off
hostcomplete   	off
huponexit      	off
inherit_errexit	off
interactive_comments	on
lastpipe       	off
lithist        	off
localvar_inherit	off
localvar_unset 	off
login_shell    	off
mailwarn       	off
no_empty_cmd_completion	off
nocaseglob     	off
nocasematch    	off
nullglob       	off
progcomp       	on
progcomp_alias 	off
promptvars     	on
restricted_shell	off
shift_verbose  	off
sourcepath     	on
xpg_echo       	off
</code>